i
Table of Contents

0. Introduction
table of contents — preface — bibliography

1. Special Relativity and Flat Spacetime
the spacetime interval — the metric — Lorentz transformations — spacetime diagrams
— vectors — the tangent space — dual vectors — tensors — tensor products — the
Levi-Civita tensor — index manipulation — electromagnetism — differential forms —
Hodge duality — worldlines — proper time — energy-momentum vector — energy-
momentum tensor — perfect fluids — energy-momentum conservation

2. Manifolds
examples — non-examples — maps — continuity — the chain rule — open sets —
charts and atlases — manifolds — examples of charts — differentiation — vectors as
derivatives — coordinate bases — the tensor transformation law — partial derivatives
are not tensors — the metric again — canonical form of the metric — Riemann normal
coordinates — tensor densities — volume forms and integration

3. Curvature
covariant derivatives and connections — connection coefficients — transformation
properties — the Christoffel connection — structures on manifolds — parallel trans-
port — the parallel propagator — geodesics — affine parameters — the exponential
map — the Riemann curvature tensor — symmetries of the Riemann tensor — the
Bianchi identity — Ricci and Einstein tensors — Weyl tensor — simple examples
— geodesic deviation — tetrads and non-coordinate bases — the spin connection —
Maurer-Cartan structure equations — fiber bundles and gauge transformations

4. Gravitation
the Principle of Equivalence — gravitational redshift — gravitation as spacetime cur-
vature — the Newtonian limit — physics in curved spacetime — Einstein’s equations
— the Hilbert action — the energy-momentum tensor again — the Weak Energy Con-
dition — alternative theories — the initial value problem — gauge invariance and
harmonic gauge — domains of dependence — causality

5. More Geometry
pullbacks and pushforwards — diffeomorphisms — integral curves — Lie derivatives
— the energy-momentum tensor one more time — isometries and Killing vectors
